NO ./textures/quake/MetalPanel-01V_64.xpm
SO ./textures/quake/MetalPanel-01_64.xpm
WE ./textures/quake/CorrugatedMetalPanel-01V_64.xpm
EA ./textures/quake/ConcretePanel-01_64.xpm

F 40,40,40                
C 10,10,0

        11111111111
     111000000000111
   110000000000000011
  110000000000000000011
 1000000000000000000001
 1000000000000000000001
100000000000N00000000001
 1000000000000000000001
 1000000000000000000001
  110000000000000000011
   110000000000000011
     111000000000111
        11111111111