NO ./textures/quake/MetalPanel-01V_64.xpm
SO ./textures/quake/MetalPanel-01_64.xpm
WE ./textures/quake/CorrugatedMetalPanel-01V_64.xpm
EA ./textures/quake/ConcretePanel-01_64.xpm

F 40,40,40                
C 10,10,0

       111111111111
     111000000000011
   110000000000000011
  110000000000000000111
 10000000000000000000011
 100000000000000000000011
110000000000N000000000011
 10000000000000000000011
 1100000000000000000001
  110000000000000000111
   111000000000000011
     111000000000111
       11111111111