NO ./textures/wolfenstein/adolf.xpm
SO ./textures/wolfenstein/grey_stone.xpm
WE ./textures/wolfenstein/blue_stone.xpm
EA ./textures/wolfenstein/mossy.xpm

F 220,100,0                
C 225,30,0

    111111
1111100001
1000000001
1000N00001
1000000001
1000000001
1111111111